Word	Alternative
aanschellen	aanbellen
altoos	
altoosdurend	
bakvis	
bakvisje	
bakvisjes	
bakvissen	
blode	laf;bedeesd;verlegen
deerne	meisje
deernen	meisjes
doorluchtiger	voornamer;verhevener
doorluchtige	voorname;verhevene
doorluchtigheden	voornaamheden;verhevenheden
doorluchtigheid	voornaamheid;verhevenheid
doorluchtigste	voornaamste;verhevenste
doorluchtig	voornaam;verheven
drinklokaal	kroeg;café
drinklokalen	kroegen;cafés
gaarne	graag
geprangd	verdrietig
heerschap	persoon
helegaar	helemaal
liefdebrand	liefdesvuur
lub	Lub
maagschap	familie
ongelden	ontgelden
plezierbuurt	hoerenbuurt
schurftheid	
vlaak	
vomeren	braken
wederkering	
zwerk	hemel
